1 1
222222222222222
200000000000002
200000000000002
200000000000002
200000000000002
200000000000002
200000000000002
211110001111112
200000000000002
200000000000002
200000000000002
200000300000002
200000000003002
200000000000002
222222222222222
6 6
4 4
5 10
10 5
