222222222222222
200000000000002
200000000000002
211111011111112
200000000000002
210111111111112
200000000000002
230000000000002
200000000000002
211111111001112
200000000000002
230000000000002
211111101111112
200000000000002
222222222222222
1 14